NO textures/
SO textures/
WE textures/
EA textures/

F 220,100,0
C 200,200,200

111111111111111
1000000000000011111
1000000000000000001
11110000000N0000111
1000000000000000001
1111111111111000001
10001   10000000011
1011111110000001111
1000000000000001
1111111111111111